NO ./sprites/stone.xpm


SO ./sprites/cobbelstone.xpm
WE ./sprites/obsidian.xpm

EA ./sprites/bookshelf.xpm

F 220,100,0
C 225,30,0

11111111111111
10000000001001
10001000001001
1S000000001001
10000000000001
10000000000001
11111111111111
