11111
1E0P1
10001
10C01
11111
