11111
1E0P1
10D01
10C01
11111
