1111111111111
10D1C00000C01
1C00010111D01
1PC0110E00001
100DD000D0001
1111111111111
