1111111111111
1001C00000C01
1C00010111001
1PC0110E00001
1111111111111
